NO ./path_to_the_north_texture
SO 
WE ./path_to_the_west_texture
EA ./path_to_the_east_texture

C 225,30,0
F 220,100,0

111111
100001
1N0001
111111